sample_id,target_id,total_reads,target_reads,target_filtered_reads,target_low_quality_reads,sequence
FLD0289,FTO_WT,153698,16681,15895,786,GCAGCATGAAGCGCACCCCGACTGCCGAGGAACGAGAGCGCGAAGCTAAGGTATGTCGGGCTCCCGGGGCCTGGAGATCTTCGTGCGCTG
FLD0289,FTO_2_sites,153698,1068,1018,50,GCAGCATGAAGCGCACCCCGACTGCCGAGGAATGAGAGCGCGAAGCTAAAGTATGTCGGGCTCCCGGGGCCTGGAGATCTTCGTGCGCTG
FLD0289,FTO_target_site,153698,194,187,7,GCAGCATGAAGCGCACCCCGACTGCCGAGGAATGAGAGCGCGAAGCTAAGGTATGTCGGGCTCCCGGGGCCTGGAGATCTTCGTGCGCTG
FLD0289,FTO_PAM_site,153698,1278,1222,56,GCAGCATGAAGCGCACCCCGACTGCCGAGGAACGAGAGCGCGAAGCTAAAGTATGTCGGGCTCCCGGGGCCTGGAGATCTTCGTGCGCTG
FLD0290,FTO_WT,148924,12729,12130,599,GCAGCATGAAGCGCACCCCGACTGCCGAGGAACGAGAGCGCGAAGCTAAGGTATGTCGGGCTCCCGGGGCCTGGAGATCTTCGTGCGCTG
FLD0290,FTO_2_sites,148924,2388,2294,94,GCAGCATGAAGCGCACCCCGACTGCCGAGGAATGAGAGCGCGAAGCTAAAGTATGTCGGGCTCCCGGGGCCTGGAGATCTTCGTGCGCTG
FLD0290,FTO_target_site,148924,904,876,28,GCAGCATGAAGCGCACCCCGACTGCCGAGGAATGAGAGCGCGAAGCTAAGGTATGTCGGGCTCCCGGGGCCTGGAGATCTTCGTGCGCTG
FLD0290,FTO_PAM_site,148924,4136,3930,206,GCAGCATGAAGCGCACCCCGACTGCCGAGGAACGAGAGCGCGAAGCTAAAGTATGTCGGGCTCCCGGGGCCTGGAGATCTTCGTGCGCTG
FLD0291,FTO_WT,215642,24994,23917,1077,GCAGCATGAAGCGCACCCCGACTGCCGAGGAACGAGAGCGCGAAGCTAAGGTATGTCGGGCTCCCGGGGCCTGGAGATCTTCGTGCGCTG
FLD0291,FTO_2_sites,215642,9705,9340,365,GCAGCATGAAGCGCACCCCGACTGCCGAGGAATGAGAGCGCGAAGCTAAAGTATGTCGGGCTCCCGGGGCCTGGAGATCTTCGTGCGCTG
FLD0291,FTO_target_site,215642,2880,2784,96,GCAGCATGAAGCGCACCCCGACTGCCGAGGAATGAGAGCGCGAAGCTAAGGTATGTCGGGCTCCCGGGGCCTGGAGATCTTCGTGCGCTG
FLD0291,FTO_PAM_site,215642,14211,13654,557,GCAGCATGAAGCGCACCCCGACTGCCGAGGAACGAGAGCGCGAAGCTAAAGTATGTCGGGCTCCCGGGGCCTGGAGATCTTCGTGCGCTG
FLD0292,FTO_WT,221218,26175,25092,1083,GCAGCATGAAGCGCACCCCGACTGCCGAGGAACGAGAGCGCGAAGCTAAGGTATGTCGGGCTCCCGGGGCCTGGAGATCTTCGTGCGCTG
FLD0292,FTO_2_sites,221218,5517,5325,192,GCAGCATGAAGCGCACCCCGACTGCCGAGGAATGAGAGCGCGAAGCTAAAGTATGTCGGGCTCCCGGGGCCTGGAGATCTTCGTGCGCTG
FLD0292,FTO_target_site,221218,2060,1966,94,GCAGCATGAAGCGCACCCCGACTGCCGAGGAATGAGAGCGCGAAGCTAAGGTATGTCGGGCTCCCGGGGCCTGGAGATCTTCGTGCGCTG
FLD0292,FTO_PAM_site,221218,8977,8592,385,GCAGCATGAAGCGCACCCCGACTGCCGAGGAACGAGAGCGCGAAGCTAAAGTATGTCGGGCTCCCGGGGCCTGGAGATCTTCGTGCGCTG
FLD0293,FTO_WT,286852,218578,209345,9233,GCAGCATGAAGCGCACCCCGACTGCCGAGGAACGAGAGCGCGAAGCTAAGGTATGTCGGGCTCCCGGGGCCTGGAGATCTTCGTGCGCTG
FLD0293,FTO_2_sites,286852,47,46,1,GCAGCATGAAGCGCACCCCGACTGCCGAGGAATGAGAGCGCGAAGCTAAAGTATGTCGGGCTCCCGGGGCCTGGAGATCTTCGTGCGCTG
FLD0293,FTO_target_site,286852,91,86,5,GCAGCATGAAGCGCACCCCGACTGCCGAGGAATGAGAGCGCGAAGCTAAGGTATGTCGGGCTCCCGGGGCCTGGAGATCTTCGTGCGCTG
FLD0293,FTO_PAM_site,286852,126,120,6,GCAGCATGAAGCGCACCCCGACTGCCGAGGAACGAGAGCGCGAAGCTAAAGTATGTCGGGCTCCCGGGGCCTGGAGATCTTCGTGCGCTG
FLD0294,FTO_WT,251320,184181,176287,7894,GCAGCATGAAGCGCACCCCGACTGCCGAGGAACGAGAGCGCGAAGCTAAGGTATGTCGGGCTCCCGGGGCCTGGAGATCTTCGTGCGCTG
FLD0294,FTO_2_sites,251320,96,92,4,GCAGCATGAAGCGCACCCCGACTGCCGAGGAATGAGAGCGCGAAGCTAAAGTATGTCGGGCTCCCGGGGCCTGGAGATCTTCGTGCGCTG
FLD0294,FTO_target_site,251320,139,133,6,GCAGCATGAAGCGCACCCCGACTGCCGAGGAATGAGAGCGCGAAGCTAAGGTATGTCGGGCTCCCGGGGCCTGGAGATCTTCGTGCGCTG
FLD0294,FTO_PAM_site,251320,182,175,7,GCAGCATGAAGCGCACCCCGACTGCCGAGGAACGAGAGCGCGAAGCTAAAGTATGTCGGGCTCCCGGGGCCTGGAGATCTTCGTGCGCTG
FLD0295,FTO_WT,282948,205509,196744,8765,GCAGCATGAAGCGCACCCCGACTGCCGAGGAACGAGAGCGCGAAGCTAAGGTATGTCGGGCTCCCGGGGCCTGGAGATCTTCGTGCGCTG
FLD0295,FTO_2_sites,282948,199,187,12,GCAGCATGAAGCGCACCCCGACTGCCGAGGAATGAGAGCGCGAAGCTAAAGTATGTCGGGCTCCCGGGGCCTGGAGATCTTCGTGCGCTG
FLD0295,FTO_target_site,282948,253,245,8,GCAGCATGAAGCGCACCCCGACTGCCGAGGAATGAGAGCGCGAAGCTAAGGTATGTCGGGCTCCCGGGGCCTGGAGATCTTCGTGCGCTG
FLD0295,FTO_PAM_site,282948,452,434,18,GCAGCATGAAGCGCACCCCGACTGCCGAGGAACGAGAGCGCGAAGCTAAAGTATGTCGGGCTCCCGGGGCCTGGAGATCTTCGTGCGCTG
FLD0296,FTO_WT,247646,182416,174665,7751,GCAGCATGAAGCGCACCCCGACTGCCGAGGAACGAGAGCGCGAAGCTAAGGTATGTCGGGCTCCCGGGGCCTGGAGATCTTCGTGCGCTG
FLD0296,FTO_2_sites,247646,270,254,16,GCAGCATGAAGCGCACCCCGACTGCCGAGGAATGAGAGCGCGAAGCTAAAGTATGTCGGGCTCCCGGGGCCTGGAGATCTTCGTGCGCTG
FLD0296,FTO_target_site,247646,152,146,6,GCAGCATGAAGCGCACCCCGACTGCCGAGGAATGAGAGCGCGAAGCTAAGGTATGTCGGGCTCCCGGGGCCTGGAGATCTTCGTGCGCTG
FLD0296,FTO_PAM_site,247646,517,495,22,GCAGCATGAAGCGCACCCCGACTGCCGAGGAACGAGAGCGCGAAGCTAAAGTATGTCGGGCTCCCGGGGCCTGGAGATCTTCGTGCGCTG
FLD0297,FTO_WT,305780,236528,226642,9886,GCAGCATGAAGCGCACCCCGACTGCCGAGGAACGAGAGCGCGAAGCTAAGGTATGTCGGGCTCCCGGGGCCTGGAGATCTTCGTGCGCTG
FLD0297,FTO_2_sites,305780,92,89,3,GCAGCATGAAGCGCACCCCGACTGCCGAGGAATGAGAGCGCGAAGCTAAAGTATGTCGGGCTCCCGGGGCCTGGAGATCTTCGTGCGCTG
FLD0297,FTO_target_site,305780,165,157,8,GCAGCATGAAGCGCACCCCGACTGCCGAGGAATGAGAGCGCGAAGCTAAGGTATGTCGGGCTCCCGGGGCCTGGAGATCTTCGTGCGCTG
FLD0297,FTO_PAM_site,305780,161,154,7,GCAGCATGAAGCGCACCCCGACTGCCGAGGAACGAGAGCGCGAAGCTAAAGTATGTCGGGCTCCCGGGGCCTGGAGATCTTCGTGCGCTG
FLD0298,FTO_WT,222386,172537,165037,7500,GCAGCATGAAGCGCACCCCGACTGCCGAGGAACGAGAGCGCGAAGCTAAGGTATGTCGGGCTCCCGGGGCCTGGAGATCTTCGTGCGCTG
FLD0298,FTO_2_sites,222386,119,118,1,GCAGCATGAAGCGCACCCCGACTGCCGAGGAATGAGAGCGCGAAGCTAAAGTATGTCGGGCTCCCGGGGCCTGGAGATCTTCGTGCGCTG
FLD0298,FTO_target_site,222386,104,100,4,GCAGCATGAAGCGCACCCCGACTGCCGAGGAATGAGAGCGCGAAGCTAAGGTATGTCGGGCTCCCGGGGCCTGGAGATCTTCGTGCGCTG
FLD0298,FTO_PAM_site,222386,172,165,7,GCAGCATGAAGCGCACCCCGACTGCCGAGGAACGAGAGCGCGAAGCTAAAGTATGTCGGGCTCCCGGGGCCTGGAGATCTTCGTGCGCTG
FLD0299,FTO_WT,257314,197161,188355,8806,GCAGCATGAAGCGCACCCCGACTGCCGAGGAACGAGAGCGCGAAGCTAAGGTATGTCGGGCTCCCGGGGCCTGGAGATCTTCGTGCGCTG
FLD0299,FTO_2_sites,257314,309,300,9,GCAGCATGAAGCGCACCCCGACTGCCGAGGAATGAGAGCGCGAAGCTAAAGTATGTCGGGCTCCCGGGGCCTGGAGATCTTCGTGCGCTG
FLD0299,FTO_target_site,257314,155,151,4,GCAGCATGAAGCGCACCCCGACTGCCGAGGAATGAGAGCGCGAAGCTAAGGTATGTCGGGCTCCCGGGGCCTGGAGATCTTCGTGCGCTG
FLD0299,FTO_PAM_site,257314,404,380,24,GCAGCATGAAGCGCACCCCGACTGCCGAGGAACGAGAGCGCGAAGCTAAAGTATGTCGGGCTCCCGGGGCCTGGAGATCTTCGTGCGCTG
FLD0300,FTO_WT,340560,264435,252818,11617,GCAGCATGAAGCGCACCCCGACTGCCGAGGAACGAGAGCGCGAAGCTAAGGTATGTCGGGCTCCCGGGGCCTGGAGATCTTCGTGCGCTG
FLD0300,FTO_2_sites,340560,673,646,27,GCAGCATGAAGCGCACCCCGACTGCCGAGGAATGAGAGCGCGAAGCTAAAGTATGTCGGGCTCCCGGGGCCTGGAGATCTTCGTGCGCTG
FLD0300,FTO_target_site,340560,424,407,17,GCAGCATGAAGCGCACCCCGACTGCCGAGGAATGAGAGCGCGAAGCTAAGGTATGTCGGGCTCCCGGGGCCTGGAGATCTTCGTGCGCTG
FLD0300,FTO_PAM_site,340560,1057,1013,44,GCAGCATGAAGCGCACCCCGACTGCCGAGGAACGAGAGCGCGAAGCTAAAGTATGTCGGGCTCCCGGGGCCTGGAGATCTTCGTGCGCTG
FLD0301,FTO_WT,271446,50564,48347,2217,GCAGCATGAAGCGCACCCCGACTGCCGAGGAACGAGAGCGCGAAGCTAAGGTATGTCGGGCTCCCGGGGCCTGGAGATCTTCGTGCGCTG
FLD0301,FTO_2_sites,271446,963,928,35,GCAGCATGAAGCGCACCCCGACTGCCGAGGAATGAGAGCGCGAAGCTAAAGTATGTCGGGCTCCCGGGGCCTGGAGATCTTCGTGCGCTG
FLD0301,FTO_target_site,271446,211,202,9,GCAGCATGAAGCGCACCCCGACTGCCGAGGAATGAGAGCGCGAAGCTAAGGTATGTCGGGCTCCCGGGGCCTGGAGATCTTCGTGCGCTG
FLD0301,FTO_PAM_site,271446,2047,1959,88,GCAGCATGAAGCGCACCCCGACTGCCGAGGAACGAGAGCGCGAAGCTAAAGTATGTCGGGCTCCCGGGGCCTGGAGATCTTCGTGCGCTG
FLD0302,FTO_WT,311468,65836,63094,2742,GCAGCATGAAGCGCACCCCGACTGCCGAGGAACGAGAGCGCGAAGCTAAGGTATGTCGGGCTCCCGGGGCCTGGAGATCTTCGTGCGCTG
FLD0302,FTO_2_sites,311468,1859,1773,86,GCAGCATGAAGCGCACCCCGACTGCCGAGGAATGAGAGCGCGAAGCTAAAGTATGTCGGGCTCCCGGGGCCTGGAGATCTTCGTGCGCTG
FLD0302,FTO_target_site,311468,1015,976,39,GCAGCATGAAGCGCACCCCGACTGCCGAGGAATGAGAGCGCGAAGCTAAGGTATGTCGGGCTCCCGGGGCCTGGAGATCTTCGTGCGCTG
FLD0302,FTO_PAM_site,311468,5209,4975,234,GCAGCATGAAGCGCACCCCGACTGCCGAGGAACGAGAGCGCGAAGCTAAAGTATGTCGGGCTCCCGGGGCCTGGAGATCTTCGTGCGCTG
FLD0303,FTO_WT,259608,35641,34111,1530,GCAGCATGAAGCGCACCCCGACTGCCGAGGAACGAGAGCGCGAAGCTAAGGTATGTCGGGCTCCCGGGGCCTGGAGATCTTCGTGCGCTG
FLD0303,FTO_2_sites,259608,6608,6369,239,GCAGCATGAAGCGCACCCCGACTGCCGAGGAATGAGAGCGCGAAGCTAAAGTATGTCGGGCTCCCGGGGCCTGGAGATCTTCGTGCGCTG
FLD0303,FTO_target_site,259608,2290,2209,81,GCAGCATGAAGCGCACCCCGACTGCCGAGGAATGAGAGCGCGAAGCTAAGGTATGTCGGGCTCCCGGGGCCTGGAGATCTTCGTGCGCTG
FLD0303,FTO_PAM_site,259608,13894,13276,618,GCAGCATGAAGCGCACCCCGACTGCCGAGGAACGAGAGCGCGAAGCTAAAGTATGTCGGGCTCCCGGGGCCTGGAGATCTTCGTGCGCTG
FLD0304,FTO_WT,239604,40454,38702,1752,GCAGCATGAAGCGCACCCCGACTGCCGAGGAACGAGAGCGCGAAGCTAAGGTATGTCGGGCTCCCGGGGCCTGGAGATCTTCGTGCGCTG
FLD0304,FTO_2_sites,239604,5029,4859,170,GCAGCATGAAGCGCACCCCGACTGCCGAGGAATGAGAGCGCGAAGCTAAAGTATGTCGGGCTCCCGGGGCCTGGAGATCTTCGTGCGCTG
FLD0304,FTO_target_site,239604,2194,2115,79,GCAGCATGAAGCGCACCCCGACTGCCGAGGAATGAGAGCGCGAAGCTAAGGTATGTCGGGCTCCCGGGGCCTGGAGATCTTCGTGCGCTG
FLD0304,FTO_PAM_site,239604,8325,7938,387,GCAGCATGAAGCGCACCCCGACTGCCGAGGAACGAGAGCGCGAAGCTAAAGTATGTCGGGCTCCCGGGGCCTGGAGATCTTCGTGCGCTG
FLD0305,FTO_WT,278424,206187,197263,8924,GCAGCATGAAGCGCACCCCGACTGCCGAGGAACGAGAGCGCGAAGCTAAGGTATGTCGGGCTCCCGGGGCCTGGAGATCTTCGTGCGCTG
FLD0305,FTO_2_sites,278424,18,17,1,GCAGCATGAAGCGCACCCCGACTGCCGAGGAATGAGAGCGCGAAGCTAAAGTATGTCGGGCTCCCGGGGCCTGGAGATCTTCGTGCGCTG
FLD0305,FTO_target_site,278424,107,102,5,GCAGCATGAAGCGCACCCCGACTGCCGAGGAATGAGAGCGCGAAGCTAAGGTATGTCGGGCTCCCGGGGCCTGGAGATCTTCGTGCGCTG
FLD0305,FTO_PAM_site,278424,198,186,12,GCAGCATGAAGCGCACCCCGACTGCCGAGGAACGAGAGCGCGAAGCTAAAGTATGTCGGGCTCCCGGGGCCTGGAGATCTTCGTGCGCTG
FLD0306,FTO_WT,330016,252179,241760,10419,GCAGCATGAAGCGCACCCCGACTGCCGAGGAACGAGAGCGCGAAGCTAAGGTATGTCGGGCTCCCGGGGCCTGGAGATCTTCGTGCGCTG
FLD0306,FTO_2_sites,330016,50,50,0,GCAGCATGAAGCGCACCCCGACTGCCGAGGAATGAGAGCGCGAAGCTAAAGTATGTCGGGCTCCCGGGGCCTGGAGATCTTCGTGCGCTG
FLD0306,FTO_target_site,330016,120,118,2,GCAGCATGAAGCGCACCCCGACTGCCGAGGAATGAGAGCGCGAAGCTAAGGTATGTCGGGCTCCCGGGGCCTGGAGATCTTCGTGCGCTG
FLD0306,FTO_PAM_site,330016,358,332,26,GCAGCATGAAGCGCACCCCGACTGCCGAGGAACGAGAGCGCGAAGCTAAAGTATGTCGGGCTCCCGGGGCCTGGAGATCTTCGTGCGCTG
FLD0307,FTO_WT,279618,210720,201673,9047,GCAGCATGAAGCGCACCCCGACTGCCGAGGAACGAGAGCGCGAAGCTAAGGTATGTCGGGCTCCCGGGGCCTGGAGATCTTCGTGCGCTG
FLD0307,FTO_2_sites,279618,119,115,4,GCAGCATGAAGCGCACCCCGACTGCCGAGGAATGAGAGCGCGAAGCTAAAGTATGTCGGGCTCCCGGGGCCTGGAGATCTTCGTGCGCTG
FLD0307,FTO_target_site,279618,132,124,8,GCAGCATGAAGCGCACCCCGACTGCCGAGGAATGAGAGCGCGAAGCTAAGGTATGTCGGGCTCCCGGGGCCTGGAGATCTTCGTGCGCTG
FLD0307,FTO_PAM_site,279618,211,203,8,GCAGCATGAAGCGCACCCCGACTGCCGAGGAACGAGAGCGCGAAGCTAAAGTATGTCGGGCTCCCGGGGCCTGGAGATCTTCGTGCGCTG
FLD0308,FTO_WT,298376,225598,216283,9315,GCAGCATGAAGCGCACCCCGACTGCCGAGGAACGAGAGCGCGAAGCTAAGGTATGTCGGGCTCCCGGGGCCTGGAGATCTTCGTGCGCTG
FLD0308,FTO_2_sites,298376,104,102,2,GCAGCATGAAGCGCACCCCGACTGCCGAGGAATGAGAGCGCGAAGCTAAAGTATGTCGGGCTCCCGGGGCCTGGAGATCTTCGTGCGCTG
FLD0308,FTO_target_site,298376,224,213,11,GCAGCATGAAGCGCACCCCGACTGCCGAGGAATGAGAGCGCGAAGCTAAGGTATGTCGGGCTCCCGGGGCCTGGAGATCTTCGTGCGCTG
FLD0308,FTO_PAM_site,298376,212,201,11,GCAGCATGAAGCGCACCCCGACTGCCGAGGAACGAGAGCGCGAAGCTAAAGTATGTCGGGCTCCCGGGGCCTGGAGATCTTCGTGCGCTG
FLD0309,FTO_WT,277510,201326,192504,8822,GCAGCATGAAGCGCACCCCGACTGCCGAGGAACGAGAGCGCGAAGCTAAGGTATGTCGGGCTCCCGGGGCCTGGAGATCTTCGTGCGCTG
FLD0309,FTO_2_sites,277510,59,56,3,GCAGCATGAAGCGCACCCCGACTGCCGAGGAATGAGAGCGCGAAGCTAAAGTATGTCGGGCTCCCGGGGCCTGGAGATCTTCGTGCGCTG
FLD0309,FTO_target_site,277510,106,102,4,GCAGCATGAAGCGCACCCCGACTGCCGAGGAATGAGAGCGCGAAGCTAAGGTATGTCGGGCTCCCGGGGCCTGGAGATCTTCGTGCGCTG
FLD0309,FTO_PAM_site,277510,133,127,6,GCAGCATGAAGCGCACCCCGACTGCCGAGGAACGAGAGCGCGAAGCTAAAGTATGTCGGGCTCCCGGGGCCTGGAGATCTTCGTGCGCTG
FLD0310,FTO_WT,266434,138803,132831,5972,GCAGCATGAAGCGCACCCCGACTGCCGAGGAACGAGAGCGCGAAGCTAAGGTATGTCGGGCTCCCGGGGCCTGGAGATCTTCGTGCGCTG
FLD0310,FTO_2_sites,266434,60,57,3,GCAGCATGAAGCGCACCCCGACTGCCGAGGAATGAGAGCGCGAAGCTAAAGTATGTCGGGCTCCCGGGGCCTGGAGATCTTCGTGCGCTG
FLD0310,FTO_target_site,266434,91,89,2,GCAGCATGAAGCGCACCCCGACTGCCGAGGAATGAGAGCGCGAAGCTAAGGTATGTCGGGCTCCCGGGGCCTGGAGATCTTCGTGCGCTG
FLD0310,FTO_PAM_site,266434,105,102,3,GCAGCATGAAGCGCACCCCGACTGCCGAGGAACGAGAGCGCGAAGCTAAAGTATGTCGGGCTCCCGGGGCCTGGAGATCTTCGTGCGCTG
FLD0311,FTO_WT,316658,245236,234487,10749,GCAGCATGAAGCGCACCCCGACTGCCGAGGAACGAGAGCGCGAAGCTAAGGTATGTCGGGCTCCCGGGGCCTGGAGATCTTCGTGCGCTG
FLD0311,FTO_2_sites,316658,219,213,6,GCAGCATGAAGCGCACCCCGACTGCCGAGGAATGAGAGCGCGAAGCTAAAGTATGTCGGGCTCCCGGGGCCTGGAGATCTTCGTGCGCTG
FLD0311,FTO_target_site,316658,157,153,4,GCAGCATGAAGCGCACCCCGACTGCCGAGGAATGAGAGCGCGAAGCTAAGGTATGTCGGGCTCCCGGGGCCTGGAGATCTTCGTGCGCTG
FLD0311,FTO_PAM_site,316658,378,356,22,GCAGCATGAAGCGCACCCCGACTGCCGAGGAACGAGAGCGCGAAGCTAAAGTATGTCGGGCTCCCGGGGCCTGGAGATCTTCGTGCGCTG
FLD0312,FTO_WT,310036,236257,226002,10255,GCAGCATGAAGCGCACCCCGACTGCCGAGGAACGAGAGCGCGAAGCTAAGGTATGTCGGGCTCCCGGGGCCTGGAGATCTTCGTGCGCTG
FLD0312,FTO_2_sites,310036,1767,1709,58,GCAGCATGAAGCGCACCCCGACTGCCGAGGAATGAGAGCGCGAAGCTAAAGTATGTCGGGCTCCCGGGGCCTGGAGATCTTCGTGCGCTG
FLD0312,FTO_target_site,310036,420,412,8,GCAGCATGAAGCGCACCCCGACTGCCGAGGAATGAGAGCGCGAAGCTAAGGTATGTCGGGCTCCCGGGGCCTGGAGATCTTCGTGCGCTG
FLD0312,FTO_PAM_site,310036,1096,1042,54,GCAGCATGAAGCGCACCCCGACTGCCGAGGAACGAGAGCGCGAAGCTAAAGTATGTCGGGCTCCCGGGGCCTGGAGATCTTCGTGCGCTG
FLD0313,FTO_WT,138994,17659,16877,782,GCAGCATGAAGCGCACCCCGACTGCCGAGGAACGAGAGCGCGAAGCTAAGGTATGTCGGGCTCCCGGGGCCTGGAGATCTTCGTGCGCTG
FLD0313,FTO_2_sites,138994,488,471,17,GCAGCATGAAGCGCACCCCGACTGCCGAGGAATGAGAGCGCGAAGCTAAAGTATGTCGGGCTCCCGGGGCCTGGAGATCTTCGTGCGCTG
FLD0313,FTO_target_site,138994,127,120,7,GCAGCATGAAGCGCACCCCGACTGCCGAGGAATGAGAGCGCGAAGCTAAGGTATGTCGGGCTCCCGGGGCCTGGAGATCTTCGTGCGCTG
FLD0313,FTO_PAM_site,138994,297,281,16,GCAGCATGAAGCGCACCCCGACTGCCGAGGAACGAGAGCGCGAAGCTAAAGTATGTCGGGCTCCCGGGGCCTGGAGATCTTCGTGCGCTG
FLD0314,FTO_WT,298008,77842,74449,3393,GCAGCATGAAGCGCACCCCGACTGCCGAGGAACGAGAGCGCGAAGCTAAGGTATGTCGGGCTCCCGGGGCCTGGAGATCTTCGTGCGCTG
FLD0314,FTO_2_sites,298008,1231,1187,44,GCAGCATGAAGCGCACCCCGACTGCCGAGGAATGAGAGCGCGAAGCTAAAGTATGTCGGGCTCCCGGGGCCTGGAGATCTTCGTGCGCTG
FLD0314,FTO_target_site,298008,976,935,41,GCAGCATGAAGCGCACCCCGACTGCCGAGGAATGAGAGCGCGAAGCTAAGGTATGTCGGGCTCCCGGGGCCTGGAGATCTTCGTGCGCTG
FLD0314,FTO_PAM_site,298008,3445,3306,139,GCAGCATGAAGCGCACCCCGACTGCCGAGGAACGAGAGCGCGAAGCTAAAGTATGTCGGGCTCCCGGGGCCTGGAGATCTTCGTGCGCTG
FLD0315,FTO_WT,243128,45764,43678,2086,GCAGCATGAAGCGCACCCCGACTGCCGAGGAACGAGAGCGCGAAGCTAAGGTATGTCGGGCTCCCGGGGCCTGGAGATCTTCGTGCGCTG
FLD0315,FTO_2_sites,243128,4675,4503,172,GCAGCATGAAGCGCACCCCGACTGCCGAGGAATGAGAGCGCGAAGCTAAAGTATGTCGGGCTCCCGGGGCCTGGAGATCTTCGTGCGCTG
FLD0315,FTO_target_site,243128,1568,1512,56,GCAGCATGAAGCGCACCCCGACTGCCGAGGAATGAGAGCGCGAAGCTAAGGTATGTCGGGCTCCCGGGGCCTGGAGATCTTCGTGCGCTG
FLD0315,FTO_PAM_site,243128,9711,9287,424,GCAGCATGAAGCGCACCCCGACTGCCGAGGAACGAGAGCGCGAAGCTAAAGTATGTCGGGCTCCCGGGGCCTGGAGATCTTCGTGCGCTG
FLD0316,FTO_WT,191426,33975,32546,1429,GCAGCATGAAGCGCACCCCGACTGCCGAGGAACGAGAGCGCGAAGCTAAGGTATGTCGGGCTCCCGGGGCCTGGAGATCTTCGTGCGCTG
FLD0316,FTO_2_sites,191426,2495,2416,79,GCAGCATGAAGCGCACCCCGACTGCCGAGGAATGAGAGCGCGAAGCTAAAGTATGTCGGGCTCCCGGGGCCTGGAGATCTTCGTGCGCTG
FLD0316,FTO_target_site,191426,1353,1315,38,GCAGCATGAAGCGCACCCCGACTGCCGAGGAATGAGAGCGCGAAGCTAAGGTATGTCGGGCTCCCGGGGCCTGGAGATCTTCGTGCGCTG
FLD0316,FTO_PAM_site,191426,6019,5781,238,GCAGCATGAAGCGCACCCCGACTGCCGAGGAACGAGAGCGCGAAGCTAAAGTATGTCGGGCTCCCGGGGCCTGGAGATCTTCGTGCGCTG
FLD0317,FTO_WT,295862,223133,213466,9667,GCAGCATGAAGCGCACCCCGACTGCCGAGGAACGAGAGCGCGAAGCTAAGGTATGTCGGGCTCCCGGGGCCTGGAGATCTTCGTGCGCTG
FLD0317,FTO_2_sites,295862,15,14,1,GCAGCATGAAGCGCACCCCGACTGCCGAGGAATGAGAGCGCGAAGCTAAAGTATGTCGGGCTCCCGGGGCCTGGAGATCTTCGTGCGCTG
FLD0317,FTO_target_site,295862,82,76,6,GCAGCATGAAGCGCACCCCGACTGCCGAGGAATGAGAGCGCGAAGCTAAGGTATGTCGGGCTCCCGGGGCCTGGAGATCTTCGTGCGCTG
FLD0317,FTO_PAM_site,295862,115,111,4,GCAGCATGAAGCGCACCCCGACTGCCGAGGAACGAGAGCGCGAAGCTAAAGTATGTCGGGCTCCCGGGGCCTGGAGATCTTCGTGCGCTG
FLD0318,FTO_WT,319084,242360,232298,10062,GCAGCATGAAGCGCACCCCGACTGCCGAGGAACGAGAGCGCGAAGCTAAGGTATGTCGGGCTCCCGGGGCCTGGAGATCTTCGTGCGCTG
FLD0318,FTO_2_sites,319084,45,43,2,GCAGCATGAAGCGCACCCCGACTGCCGAGGAATGAGAGCGCGAAGCTAAAGTATGTCGGGCTCCCGGGGCCTGGAGATCTTCGTGCGCTG
FLD0318,FTO_target_site,319084,121,114,7,GCAGCATGAAGCGCACCCCGACTGCCGAGGAATGAGAGCGCGAAGCTAAGGTATGTCGGGCTCCCGGGGCCTGGAGATCTTCGTGCGCTG
FLD0318,FTO_PAM_site,319084,137,133,4,GCAGCATGAAGCGCACCCCGACTGCCGAGGAACGAGAGCGCGAAGCTAAAGTATGTCGGGCTCCCGGGGCCTGGAGATCTTCGTGCGCTG
FLD0319,FTO_WT,316968,238312,227854,10458,GCAGCATGAAGCGCACCCCGACTGCCGAGGAACGAGAGCGCGAAGCTAAGGTATGTCGGGCTCCCGGGGCCTGGAGATCTTCGTGCGCTG
FLD0319,FTO_2_sites,316968,48,48,0,GCAGCATGAAGCGCACCCCGACTGCCGAGGAATGAGAGCGCGAAGCTAAAGTATGTCGGGCTCCCGGGGCCTGGAGATCTTCGTGCGCTG
FLD0319,FTO_target_site,316968,131,128,3,GCAGCATGAAGCGCACCCCGACTGCCGAGGAATGAGAGCGCGAAGCTAAGGTATGTCGGGCTCCCGGGGCCTGGAGATCTTCGTGCGCTG
FLD0319,FTO_PAM_site,316968,293,284,9,GCAGCATGAAGCGCACCCCGACTGCCGAGGAACGAGAGCGCGAAGCTAAAGTATGTCGGGCTCCCGGGGCCTGGAGATCTTCGTGCGCTG
FLD0320,FTO_WT,410206,313663,300468,13195,GCAGCATGAAGCGCACCCCGACTGCCGAGGAACGAGAGCGCGAAGCTAAGGTATGTCGGGCTCCCGGGGCCTGGAGATCTTCGTGCGCTG
FLD0320,FTO_2_sites,410206,166,159,7,GCAGCATGAAGCGCACCCCGACTGCCGAGGAATGAGAGCGCGAAGCTAAAGTATGTCGGGCTCCCGGGGCCTGGAGATCTTCGTGCGCTG
FLD0320,FTO_target_site,410206,198,187,11,GCAGCATGAAGCGCACCCCGACTGCCGAGGAATGAGAGCGCGAAGCTAAGGTATGTCGGGCTCCCGGGGCCTGGAGATCTTCGTGCGCTG
FLD0320,FTO_PAM_site,410206,278,261,17,GCAGCATGAAGCGCACCCCGACTGCCGAGGAACGAGAGCGCGAAGCTAAAGTATGTCGGGCTCCCGGGGCCTGGAGATCTTCGTGCGCTG
FLD0321,FTO_WT,233714,181376,173428,7948,GCAGCATGAAGCGCACCCCGACTGCCGAGGAACGAGAGCGCGAAGCTAAGGTATGTCGGGCTCCCGGGGCCTGGAGATCTTCGTGCGCTG
FLD0321,FTO_2_sites,233714,34,34,0,GCAGCATGAAGCGCACCCCGACTGCCGAGGAATGAGAGCGCGAAGCTAAAGTATGTCGGGCTCCCGGGGCCTGGAGATCTTCGTGCGCTG
FLD0321,FTO_target_site,233714,118,113,5,GCAGCATGAAGCGCACCCCGACTGCCGAGGAATGAGAGCGCGAAGCTAAGGTATGTCGGGCTCCCGGGGCCTGGAGATCTTCGTGCGCTG
FLD0321,FTO_PAM_site,233714,74,70,4,GCAGCATGAAGCGCACCCCGACTGCCGAGGAACGAGAGCGCGAAGCTAAAGTATGTCGGGCTCCCGGGGCCTGGAGATCTTCGTGCGCTG
FLD0322,FTO_WT,309730,239313,228578,10735,GCAGCATGAAGCGCACCCCGACTGCCGAGGAACGAGAGCGCGAAGCTAAGGTATGTCGGGCTCCCGGGGCCTGGAGATCTTCGTGCGCTG
FLD0322,FTO_2_sites,309730,50,48,2,GCAGCATGAAGCGCACCCCGACTGCCGAGGAATGAGAGCGCGAAGCTAAAGTATGTCGGGCTCCCGGGGCCTGGAGATCTTCGTGCGCTG
FLD0322,FTO_target_site,309730,138,126,12,GCAGCATGAAGCGCACCCCGACTGCCGAGGAATGAGAGCGCGAAGCTAAGGTATGTCGGGCTCCCGGGGCCTGGAGATCTTCGTGCGCTG
FLD0322,FTO_PAM_site,309730,282,270,12,GCAGCATGAAGCGCACCCCGACTGCCGAGGAACGAGAGCGCGAAGCTAAAGTATGTCGGGCTCCCGGGGCCTGGAGATCTTCGTGCGCTG
FLD0323,FTO_WT,222184,172300,164740,7560,GCAGCATGAAGCGCACCCCGACTGCCGAGGAACGAGAGCGCGAAGCTAAGGTATGTCGGGCTCCCGGGGCCTGGAGATCTTCGTGCGCTG
FLD0323,FTO_2_sites,222184,73,71,2,GCAGCATGAAGCGCACCCCGACTGCCGAGGAATGAGAGCGCGAAGCTAAAGTATGTCGGGCTCCCGGGGCCTGGAGATCTTCGTGCGCTG
FLD0323,FTO_target_site,222184,144,136,8,GCAGCATGAAGCGCACCCCGACTGCCGAGGAATGAGAGCGCGAAGCTAAGGTATGTCGGGCTCCCGGGGCCTGGAGATCTTCGTGCGCTG
FLD0323,FTO_PAM_site,222184,194,188,6,GCAGCATGAAGCGCACCCCGACTGCCGAGGAACGAGAGCGCGAAGCTAAAGTATGTCGGGCTCCCGGGGCCTGGAGATCTTCGTGCGCTG
FLD0324,FTO_WT,130176,51511,49336,2175,GCAGCATGAAGCGCACCCCGACTGCCGAGGAACGAGAGCGCGAAGCTAAGGTATGTCGGGCTCCCGGGGCCTGGAGATCTTCGTGCGCTG
FLD0324,FTO_2_sites,130176,121,120,1,GCAGCATGAAGCGCACCCCGACTGCCGAGGAATGAGAGCGCGAAGCTAAAGTATGTCGGGCTCCCGGGGCCTGGAGATCTTCGTGCGCTG
FLD0324,FTO_target_site,130176,94,93,1,GCAGCATGAAGCGCACCCCGACTGCCGAGGAATGAGAGCGCGAAGCTAAGGTATGTCGGGCTCCCGGGGCCTGGAGATCTTCGTGCGCTG
FLD0324,FTO_PAM_site,130176,150,144,6,GCAGCATGAAGCGCACCCCGACTGCCGAGGAACGAGAGCGCGAAGCTAAAGTATGTCGGGCTCCCGGGGCCTGGAGATCTTCGTGCGCTG
