sample_id,target_id,total_reads,target_reads,target_filtered_reads,target_low_quality_reads,sequence
FLD0193,FTO_WT,257462,42090,41443,647,GCAGCATGAAGCGCACCCCGACTGCCGAGGAACGAGAGCGCGAAGCTAAGGTATGTCGGGCTCCCGGGGCCTGGAGATCTTCGTGCGCTG
FLD0193,FTO_2_sites,257462,2126,2094,32,GCAGCATGAAGCGCACCCCGACTGCCGAGGAATGAGAGCGCGAAGCTAAAGTATGTCGGGCTCCCGGGGCCTGGAGATCTTCGTGCGCTG
FLD0193,FTO_target_site,257462,1249,1234,15,GCAGCATGAAGCGCACCCCGACTGCCGAGGAATGAGAGCGCGAAGCTAAGGTATGTCGGGCTCCCGGGGCCTGGAGATCTTCGTGCGCTG
FLD0193,FTO_PAM_site,257462,3302,3251,51,GCAGCATGAAGCGCACCCCGACTGCCGAGGAACGAGAGCGCGAAGCTAAAGTATGTCGGGCTCCCGGGGCCTGGAGATCTTCGTGCGCTG
FLD0194,FTO_WT,257088,27558,27160,398,GCAGCATGAAGCGCACCCCGACTGCCGAGGAACGAGAGCGCGAAGCTAAGGTATGTCGGGCTCCCGGGGCCTGGAGATCTTCGTGCGCTG
FLD0194,FTO_2_sites,257088,6746,6671,75,GCAGCATGAAGCGCACCCCGACTGCCGAGGAATGAGAGCGCGAAGCTAAAGTATGTCGGGCTCCCGGGGCCTGGAGATCTTCGTGCGCTG
FLD0194,FTO_target_site,257088,2988,2955,33,GCAGCATGAAGCGCACCCCGACTGCCGAGGAATGAGAGCGCGAAGCTAAGGTATGTCGGGCTCCCGGGGCCTGGAGATCTTCGTGCGCTG
FLD0194,FTO_PAM_site,257088,12003,11825,178,GCAGCATGAAGCGCACCCCGACTGCCGAGGAACGAGAGCGCGAAGCTAAAGTATGTCGGGCTCCCGGGGCCTGGAGATCTTCGTGCGCTG
FLD0195,FTO_WT,240028,32603,32128,475,GCAGCATGAAGCGCACCCCGACTGCCGAGGAACGAGAGCGCGAAGCTAAGGTATGTCGGGCTCCCGGGGCCTGGAGATCTTCGTGCGCTG
FLD0195,FTO_2_sites,240028,4634,4573,61,GCAGCATGAAGCGCACCCCGACTGCCGAGGAATGAGAGCGCGAAGCTAAAGTATGTCGGGCTCCCGGGGCCTGGAGATCTTCGTGCGCTG
FLD0195,FTO_target_site,240028,3556,3504,52,GCAGCATGAAGCGCACCCCGACTGCCGAGGAATGAGAGCGCGAAGCTAAGGTATGTCGGGCTCCCGGGGCCTGGAGATCTTCGTGCGCTG
FLD0195,FTO_PAM_site,240028,7318,7206,112,GCAGCATGAAGCGCACCCCGACTGCCGAGGAACGAGAGCGCGAAGCTAAAGTATGTCGGGCTCCCGGGGCCTGGAGATCTTCGTGCGCTG
FLD0196,FTO_WT,243156,39671,39096,575,GCAGCATGAAGCGCACCCCGACTGCCGAGGAACGAGAGCGCGAAGCTAAGGTATGTCGGGCTCCCGGGGCCTGGAGATCTTCGTGCGCTG
FLD0196,FTO_2_sites,243156,3,2,1,GCAGCATGAAGCGCACCCCGACTGCCGAGGAATGAGAGCGCGAAGCTAAAGTATGTCGGGCTCCCGGGGCCTGGAGATCTTCGTGCGCTG
FLD0196,FTO_target_site,243156,16,15,1,GCAGCATGAAGCGCACCCCGACTGCCGAGGAATGAGAGCGCGAAGCTAAGGTATGTCGGGCTCCCGGGGCCTGGAGATCTTCGTGCGCTG
FLD0196,FTO_PAM_site,243156,12,12,0,GCAGCATGAAGCGCACCCCGACTGCCGAGGAACGAGAGCGCGAAGCTAAAGTATGTCGGGCTCCCGGGGCCTGGAGATCTTCGTGCGCTG
FLD0205,FTO_WT,186426,36131,35625,506,GCAGCATGAAGCGCACCCCGACTGCCGAGGAACGAGAGCGCGAAGCTAAGGTATGTCGGGCTCCCGGGGCCTGGAGATCTTCGTGCGCTG
FLD0205,FTO_2_sites,186426,1821,1795,26,GCAGCATGAAGCGCACCCCGACTGCCGAGGAATGAGAGCGCGAAGCTAAAGTATGTCGGGCTCCCGGGGCCTGGAGATCTTCGTGCGCTG
FLD0205,FTO_target_site,186426,976,964,12,GCAGCATGAAGCGCACCCCGACTGCCGAGGAATGAGAGCGCGAAGCTAAGGTATGTCGGGCTCCCGGGGCCTGGAGATCTTCGTGCGCTG
FLD0205,FTO_PAM_site,186426,2549,2523,26,GCAGCATGAAGCGCACCCCGACTGCCGAGGAACGAGAGCGCGAAGCTAAAGTATGTCGGGCTCCCGGGGCCTGGAGATCTTCGTGCGCTG
FLD0206,FTO_WT,238566,28326,27906,420,GCAGCATGAAGCGCACCCCGACTGCCGAGGAACGAGAGCGCGAAGCTAAGGTATGTCGGGCTCCCGGGGCCTGGAGATCTTCGTGCGCTG
FLD0206,FTO_2_sites,238566,6059,6003,56,GCAGCATGAAGCGCACCCCGACTGCCGAGGAATGAGAGCGCGAAGCTAAAGTATGTCGGGCTCCCGGGGCCTGGAGATCTTCGTGCGCTG
FLD0206,FTO_target_site,238566,2499,2466,33,GCAGCATGAAGCGCACCCCGACTGCCGAGGAATGAGAGCGCGAAGCTAAGGTATGTCGGGCTCCCGGGGCCTGGAGATCTTCGTGCGCTG
FLD0206,FTO_PAM_site,238566,8791,8650,141,GCAGCATGAAGCGCACCCCGACTGCCGAGGAACGAGAGCGCGAAGCTAAAGTATGTCGGGCTCCCGGGGCCTGGAGATCTTCGTGCGCTG
FLD0207,FTO_WT,297866,48083,47463,620,GCAGCATGAAGCGCACCCCGACTGCCGAGGAACGAGAGCGCGAAGCTAAGGTATGTCGGGCTCCCGGGGCCTGGAGATCTTCGTGCGCTG
FLD0207,FTO_2_sites,297866,5268,5205,63,GCAGCATGAAGCGCACCCCGACTGCCGAGGAATGAGAGCGCGAAGCTAAAGTATGTCGGGCTCCCGGGGCCTGGAGATCTTCGTGCGCTG
FLD0207,FTO_target_site,297866,2629,2597,32,GCAGCATGAAGCGCACCCCGACTGCCGAGGAATGAGAGCGCGAAGCTAAGGTATGTCGGGCTCCCGGGGCCTGGAGATCTTCGTGCGCTG
FLD0207,FTO_PAM_site,297866,8344,8230,114,GCAGCATGAAGCGCACCCCGACTGCCGAGGAACGAGAGCGCGAAGCTAAAGTATGTCGGGCTCCCGGGGCCTGGAGATCTTCGTGCGCTG
FLD0208,FTO_WT,191398,60046,59197,849,GCAGCATGAAGCGCACCCCGACTGCCGAGGAACGAGAGCGCGAAGCTAAGGTATGTCGGGCTCCCGGGGCCTGGAGATCTTCGTGCGCTG
FLD0208,FTO_2_sites,191398,2,2,0,GCAGCATGAAGCGCACCCCGACTGCCGAGGAATGAGAGCGCGAAGCTAAAGTATGTCGGGCTCCCGGGGCCTGGAGATCTTCGTGCGCTG
FLD0208,FTO_target_site,191398,24,24,0,GCAGCATGAAGCGCACCCCGACTGCCGAGGAATGAGAGCGCGAAGCTAAGGTATGTCGGGCTCCCGGGGCCTGGAGATCTTCGTGCGCTG
FLD0208,FTO_PAM_site,191398,26,26,0,GCAGCATGAAGCGCACCCCGACTGCCGAGGAACGAGAGCGCGAAGCTAAAGTATGTCGGGCTCCCGGGGCCTGGAGATCTTCGTGCGCTG
FLD0217,FTO_WT,295286,59379,58511,868,GCAGCATGAAGCGCACCCCGACTGCCGAGGAACGAGAGCGCGAAGCTAAGGTATGTCGGGCTCCCGGGGCCTGGAGATCTTCGTGCGCTG
FLD0217,FTO_2_sites,295286,2496,2465,31,GCAGCATGAAGCGCACCCCGACTGCCGAGGAATGAGAGCGCGAAGCTAAAGTATGTCGGGCTCCCGGGGCCTGGAGATCTTCGTGCGCTG
FLD0217,FTO_target_site,295286,1146,1136,10,GCAGCATGAAGCGCACCCCGACTGCCGAGGAATGAGAGCGCGAAGCTAAGGTATGTCGGGCTCCCGGGGCCTGGAGATCTTCGTGCGCTG
FLD0217,FTO_PAM_site,295286,3441,3389,52,GCAGCATGAAGCGCACCCCGACTGCCGAGGAACGAGAGCGCGAAGCTAAAGTATGTCGGGCTCCCGGGGCCTGGAGATCTTCGTGCGCTG
FLD0218,FTO_WT,236072,23783,23457,326,GCAGCATGAAGCGCACCCCGACTGCCGAGGAACGAGAGCGCGAAGCTAAGGTATGTCGGGCTCCCGGGGCCTGGAGATCTTCGTGCGCTG
FLD0218,FTO_2_sites,236072,4827,4758,69,GCAGCATGAAGCGCACCCCGACTGCCGAGGAATGAGAGCGCGAAGCTAAAGTATGTCGGGCTCCCGGGGCCTGGAGATCTTCGTGCGCTG
FLD0218,FTO_target_site,236072,2288,2265,23,GCAGCATGAAGCGCACCCCGACTGCCGAGGAATGAGAGCGCGAAGCTAAGGTATGTCGGGCTCCCGGGGCCTGGAGATCTTCGTGCGCTG
FLD0218,FTO_PAM_site,236072,7385,7275,110,GCAGCATGAAGCGCACCCCGACTGCCGAGGAACGAGAGCGCGAAGCTAAAGTATGTCGGGCTCCCGGGGCCTGGAGATCTTCGTGCGCTG
FLD0219,FTO_WT,194858,40422,39886,536,GCAGCATGAAGCGCACCCCGACTGCCGAGGAACGAGAGCGCGAAGCTAAGGTATGTCGGGCTCCCGGGGCCTGGAGATCTTCGTGCGCTG
FLD0219,FTO_2_sites,194858,2791,2755,36,GCAGCATGAAGCGCACCCCGACTGCCGAGGAATGAGAGCGCGAAGCTAAAGTATGTCGGGCTCCCGGGGCCTGGAGATCTTCGTGCGCTG
FLD0219,FTO_target_site,194858,2152,2121,31,GCAGCATGAAGCGCACCCCGACTGCCGAGGAATGAGAGCGCGAAGCTAAGGTATGTCGGGCTCCCGGGGCCTGGAGATCTTCGTGCGCTG
FLD0219,FTO_PAM_site,194858,5830,5737,93,GCAGCATGAAGCGCACCCCGACTGCCGAGGAACGAGAGCGCGAAGCTAAAGTATGTCGGGCTCCCGGGGCCTGGAGATCTTCGTGCGCTG
FLD0220,FTO_WT,186828,69877,68967,910,GCAGCATGAAGCGCACCCCGACTGCCGAGGAACGAGAGCGCGAAGCTAAGGTATGTCGGGCTCCCGGGGCCTGGAGATCTTCGTGCGCTG
FLD0220,FTO_2_sites,186828,2,2,0,GCAGCATGAAGCGCACCCCGACTGCCGAGGAATGAGAGCGCGAAGCTAAAGTATGTCGGGCTCCCGGGGCCTGGAGATCTTCGTGCGCTG
FLD0220,FTO_target_site,186828,21,21,0,GCAGCATGAAGCGCACCCCGACTGCCGAGGAATGAGAGCGCGAAGCTAAGGTATGTCGGGCTCCCGGGGCCTGGAGATCTTCGTGCGCTG
FLD0220,FTO_PAM_site,186828,32,30,2,GCAGCATGAAGCGCACCCCGACTGCCGAGGAACGAGAGCGCGAAGCTAAAGTATGTCGGGCTCCCGGGGCCTGGAGATCTTCGTGCGCTG
FLD0329,FTO_WT,369124,48764,48061,703,GCAGCATGAAGCGCACCCCGACTGCCGAGGAACGAGAGCGCGAAGCTAAGGTATGTCGGGCTCCCGGGGCCTGGAGATCTTCGTGCGCTG
FLD0329,FTO_2_sites,369124,2625,2599,26,GCAGCATGAAGCGCACCCCGACTGCCGAGGAATGAGAGCGCGAAGCTAAAGTATGTCGGGCTCCCGGGGCCTGGAGATCTTCGTGCGCTG
FLD0329,FTO_target_site,369124,1649,1631,18,GCAGCATGAAGCGCACCCCGACTGCCGAGGAATGAGAGCGCGAAGCTAAGGTATGTCGGGCTCCCGGGGCCTGGAGATCTTCGTGCGCTG
FLD0329,FTO_PAM_site,369124,4084,4013,71,GCAGCATGAAGCGCACCCCGACTGCCGAGGAACGAGAGCGCGAAGCTAAAGTATGTCGGGCTCCCGGGGCCTGGAGATCTTCGTGCGCTG
FLD0330,FTO_WT,327726,24008,23652,356,GCAGCATGAAGCGCACCCCGACTGCCGAGGAACGAGAGCGCGAAGCTAAGGTATGTCGGGCTCCCGGGGCCTGGAGATCTTCGTGCGCTG
FLD0330,FTO_2_sites,327726,5541,5466,75,GCAGCATGAAGCGCACCCCGACTGCCGAGGAATGAGAGCGCGAAGCTAAAGTATGTCGGGCTCCCGGGGCCTGGAGATCTTCGTGCGCTG
FLD0330,FTO_target_site,327726,2577,2541,36,GCAGCATGAAGCGCACCCCGACTGCCGAGGAATGAGAGCGCGAAGCTAAGGTATGTCGGGCTCCCGGGGCCTGGAGATCTTCGTGCGCTG
FLD0330,FTO_PAM_site,327726,9418,9276,142,GCAGCATGAAGCGCACCCCGACTGCCGAGGAACGAGAGCGCGAAGCTAAAGTATGTCGGGCTCCCGGGGCCTGGAGATCTTCGTGCGCTG
FLD0331,FTO_WT,243752,19672,19395,277,GCAGCATGAAGCGCACCCCGACTGCCGAGGAACGAGAGCGCGAAGCTAAGGTATGTCGGGCTCCCGGGGCCTGGAGATCTTCGTGCGCTG
FLD0331,FTO_2_sites,243752,4380,4334,46,GCAGCATGAAGCGCACCCCGACTGCCGAGGAATGAGAGCGCGAAGCTAAAGTATGTCGGGCTCCCGGGGCCTGGAGATCTTCGTGCGCTG
FLD0331,FTO_target_site,243752,2207,2181,26,GCAGCATGAAGCGCACCCCGACTGCCGAGGAATGAGAGCGCGAAGCTAAGGTATGTCGGGCTCCCGGGGCCTGGAGATCTTCGTGCGCTG
FLD0331,FTO_PAM_site,243752,6457,6350,107,GCAGCATGAAGCGCACCCCGACTGCCGAGGAACGAGAGCGCGAAGCTAAAGTATGTCGGGCTCCCGGGGCCTGGAGATCTTCGTGCGCTG
FLD0332,FTO_WT,356898,68207,67253,954,GCAGCATGAAGCGCACCCCGACTGCCGAGGAACGAGAGCGCGAAGCTAAGGTATGTCGGGCTCCCGGGGCCTGGAGATCTTCGTGCGCTG
FLD0332,FTO_target_site,356898,40,39,1,GCAGCATGAAGCGCACCCCGACTGCCGAGGAATGAGAGCGCGAAGCTAAGGTATGTCGGGCTCCCGGGGCCTGGAGATCTTCGTGCGCTG
FLD0332,FTO_PAM_site,356898,40,36,4,GCAGCATGAAGCGCACCCCGACTGCCGAGGAACGAGAGCGCGAAGCTAAAGTATGTCGGGCTCCCGGGGCCTGGAGATCTTCGTGCGCTG
FLD0341,FTO_WT,305446,38668,38085,583,GCAGCATGAAGCGCACCCCGACTGCCGAGGAACGAGAGCGCGAAGCTAAGGTATGTCGGGCTCCCGGGGCCTGGAGATCTTCGTGCGCTG
FLD0341,FTO_2_sites,305446,1355,1343,12,GCAGCATGAAGCGCACCCCGACTGCCGAGGAATGAGAGCGCGAAGCTAAAGTATGTCGGGCTCCCGGGGCCTGGAGATCTTCGTGCGCTG
FLD0341,FTO_target_site,305446,811,802,9,GCAGCATGAAGCGCACCCCGACTGCCGAGGAATGAGAGCGCGAAGCTAAGGTATGTCGGGCTCCCGGGGCCTGGAGATCTTCGTGCGCTG
FLD0341,FTO_PAM_site,305446,2629,2583,46,GCAGCATGAAGCGCACCCCGACTGCCGAGGAACGAGAGCGCGAAGCTAAAGTATGTCGGGCTCCCGGGGCCTGGAGATCTTCGTGCGCTG
FLD0342,FTO_WT,257274,15042,14812,230,GCAGCATGAAGCGCACCCCGACTGCCGAGGAACGAGAGCGCGAAGCTAAGGTATGTCGGGCTCCCGGGGCCTGGAGATCTTCGTGCGCTG
FLD0342,FTO_2_sites,257274,3073,3035,38,GCAGCATGAAGCGCACCCCGACTGCCGAGGAATGAGAGCGCGAAGCTAAAGTATGTCGGGCTCCCGGGGCCTGGAGATCTTCGTGCGCTG
FLD0342,FTO_target_site,257274,1719,1704,15,GCAGCATGAAGCGCACCCCGACTGCCGAGGAATGAGAGCGCGAAGCTAAGGTATGTCGGGCTCCCGGGGCCTGGAGATCTTCGTGCGCTG
FLD0342,FTO_PAM_site,257274,4699,4621,78,GCAGCATGAAGCGCACCCCGACTGCCGAGGAACGAGAGCGCGAAGCTAAAGTATGTCGGGCTCCCGGGGCCTGGAGATCTTCGTGCGCTG
FLD0343,FTO_WT,335712,41463,40796,667,GCAGCATGAAGCGCACCCCGACTGCCGAGGAACGAGAGCGCGAAGCTAAGGTATGTCGGGCTCCCGGGGCCTGGAGATCTTCGTGCGCTG
FLD0343,FTO_2_sites,335712,4728,4658,70,GCAGCATGAAGCGCACCCCGACTGCCGAGGAATGAGAGCGCGAAGCTAAAGTATGTCGGGCTCCCGGGGCCTGGAGATCTTCGTGCGCTG
FLD0343,FTO_target_site,335712,2117,2094,23,GCAGCATGAAGCGCACCCCGACTGCCGAGGAATGAGAGCGCGAAGCTAAGGTATGTCGGGCTCCCGGGGCCTGGAGATCTTCGTGCGCTG
FLD0343,FTO_PAM_site,335712,7090,6991,99,GCAGCATGAAGCGCACCCCGACTGCCGAGGAACGAGAGCGCGAAGCTAAAGTATGTCGGGCTCCCGGGGCCTGGAGATCTTCGTGCGCTG
FLD0344,FTO_WT,30960,3385,3342,43,GCAGCATGAAGCGCACCCCGACTGCCGAGGAACGAGAGCGCGAAGCTAAGGTATGTCGGGCTCCCGGGGCCTGGAGATCTTCGTGCGCTG
FLD0344,FTO_target_site,30960,2,2,0,GCAGCATGAAGCGCACCCCGACTGCCGAGGAATGAGAGCGCGAAGCTAAGGTATGTCGGGCTCCCGGGGCCTGGAGATCTTCGTGCGCTG
FLD0344,FTO_PAM_site,30960,2,2,0,GCAGCATGAAGCGCACCCCGACTGCCGAGGAACGAGAGCGCGAAGCTAAAGTATGTCGGGCTCCCGGGGCCTGGAGATCTTCGTGCGCTG
FLD0353,FTO_WT,461942,75524,74340,1184,GCAGCATGAAGCGCACCCCGACTGCCGAGGAACGAGAGCGCGAAGCTAAGGTATGTCGGGCTCCCGGGGCCTGGAGATCTTCGTGCGCTG
FLD0353,FTO_2_sites,461942,2821,2782,39,GCAGCATGAAGCGCACCCCGACTGCCGAGGAATGAGAGCGCGAAGCTAAAGTATGTCGGGCTCCCGGGGCCTGGAGATCTTCGTGCGCTG
FLD0353,FTO_target_site,461942,1770,1749,21,GCAGCATGAAGCGCACCCCGACTGCCGAGGAATGAGAGCGCGAAGCTAAGGTATGTCGGGCTCCCGGGGCCTGGAGATCTTCGTGCGCTG
FLD0353,FTO_PAM_site,461942,5793,5707,86,GCAGCATGAAGCGCACCCCGACTGCCGAGGAACGAGAGCGCGAAGCTAAAGTATGTCGGGCTCCCGGGGCCTGGAGATCTTCGTGCGCTG
FLD0354,FTO_WT,411592,38782,38207,575,GCAGCATGAAGCGCACCCCGACTGCCGAGGAACGAGAGCGCGAAGCTAAGGTATGTCGGGCTCCCGGGGCCTGGAGATCTTCGTGCGCTG
FLD0354,FTO_2_sites,411592,8221,8127,94,GCAGCATGAAGCGCACCCCGACTGCCGAGGAATGAGAGCGCGAAGCTAAAGTATGTCGGGCTCCCGGGGCCTGGAGATCTTCGTGCGCTG
FLD0354,FTO_target_site,411592,4691,4642,49,GCAGCATGAAGCGCACCCCGACTGCCGAGGAATGAGAGCGCGAAGCTAAGGTATGTCGGGCTCCCGGGGCCTGGAGATCTTCGTGCGCTG
FLD0354,FTO_PAM_site,411592,15206,14999,207,GCAGCATGAAGCGCACCCCGACTGCCGAGGAACGAGAGCGCGAAGCTAAAGTATGTCGGGCTCCCGGGGCCTGGAGATCTTCGTGCGCTG
FLD0355,FTO_WT,256224,40290,39687,603,GCAGCATGAAGCGCACCCCGACTGCCGAGGAACGAGAGCGCGAAGCTAAGGTATGTCGGGCTCCCGGGGCCTGGAGATCTTCGTGCGCTG
FLD0355,FTO_2_sites,256224,4346,4299,47,GCAGCATGAAGCGCACCCCGACTGCCGAGGAATGAGAGCGCGAAGCTAAAGTATGTCGGGCTCCCGGGGCCTGGAGATCTTCGTGCGCTG
FLD0355,FTO_target_site,256224,2282,2246,36,GCAGCATGAAGCGCACCCCGACTGCCGAGGAATGAGAGCGCGAAGCTAAGGTATGTCGGGCTCCCGGGGCCTGGAGATCTTCGTGCGCTG
FLD0355,FTO_PAM_site,256224,7326,7221,105,GCAGCATGAAGCGCACCCCGACTGCCGAGGAACGAGAGCGCGAAGCTAAAGTATGTCGGGCTCCCGGGGCCTGGAGATCTTCGTGCGCTG
FLD0356,FTO_WT,316648,91262,89886,1376,GCAGCATGAAGCGCACCCCGACTGCCGAGGAACGAGAGCGCGAAGCTAAGGTATGTCGGGCTCCCGGGGCCTGGAGATCTTCGTGCGCTG
FLD0356,FTO_2_sites,316648,3,3,0,GCAGCATGAAGCGCACCCCGACTGCCGAGGAATGAGAGCGCGAAGCTAAAGTATGTCGGGCTCCCGGGGCCTGGAGATCTTCGTGCGCTG
FLD0356,FTO_target_site,316648,73,71,2,GCAGCATGAAGCGCACCCCGACTGCCGAGGAATGAGAGCGCGAAGCTAAGGTATGTCGGGCTCCCGGGGCCTGGAGATCTTCGTGCGCTG
FLD0356,FTO_PAM_site,316648,48,44,4,GCAGCATGAAGCGCACCCCGACTGCCGAGGAACGAGAGCGCGAAGCTAAAGTATGTCGGGCTCCCGGGGCCTGGAGATCTTCGTGCGCTG
